NO ./path_to_the_north_texture
SO ./path_to_the_south_texture
WE ./path_to_the_west_texture
EA ./path_to_the_east_texture

F     255,100,0
C     226,30,0

1111111111111111111111111
10000000001111111100000001
1011000001101000000001111
10010S00011111111100000001
1111111111111111111111111
