C 1,2,23
F     1,2,1




111  1111
100110N11
111111111




SO 123
NO 123
WE 123
EA 123











