NO ./textures/texture_test.xpm
SO ./textures/texture_test.xpm
WE ./textures/texture_test.xpm
EA ./textures/texture_test.xpm

F     255,100,0
C     226,30,0

11111111111111111111111111
10000000000000000000000001
10000000000000000000000001
1000S000000000000000000001
11111111111111111111111111
