NO ./textures/colorstone.xpm
SO ./textures/eagle.xpm
WE ./textures/colorstone.xpm
EA ./textures/texture_test.xpm

F     000,000,0
C     000,000,255

11111111111111111111111111
10000001000000001000000001
10000000100000001000000001
1000S000000000001000000001
11111111111111111111111111
