NO ./textures/texture_test.xpm
SO ./textures/texture_test.xpm
WE ./textures/texture_test.xpm
EA ./textures/texture_test.xpm

F     171,171,171
C     32,141,161

11111111111111111111111111
1N000001000000000000000001
10000000100000111110000001
10000000000000110010000001
10000001000000000000000001
10000000100000000000000001
10000000000000000000000001
10000001000000000000000001
10000000100000000000000001
10000000000000000000000001
11111111111111111111111111
