NO ./textures/texture_test.xpm
SO ./textures/texture_test.xpm
WE ./textures/texture_test.xpm
EA ./textures/texture_test.xpm

F     171,200,171
C     32,141,161

11111111111111111111111111111111111
1010111111        1000E0001000000001
1001            11111111000000000111
100111111111111110000000000000000001
1001            11111111000000000111
100111111111111110000000000000000001
1001            11111111000000000111
100111111111111110000000000000000001
111111111111111111111111111111111111