NO ./textures/8080.xpm
EA ./textures/wall_c_small_new_1.xpm
WE ./textures/wall_c_small.xpm
SO ./textures/wall_c_small_new.xpm

F   28,25,11
C     49,82,135

 1111111        111111111
110000011      10000000001  111111
100000001     1000000000001 100001
 1000001     100000000000001101101
  11011      100000000000000101101
   101        10000001000000001101111
   101         100001 100000001100001
   1011111111111000001000000010000001
   1000000000000000000000000100000001
   1011111111111000000000001000000001
   101         1000000000010000000001
   101        100000000001111111111011111
  11011      100000000001         1000001
 1000001     1000000N1001         111110111111111111111111111111111
100000001     10000000001         100000000000000000000000000000001
110000011      1000000001         100000000000000000000000000000001
 1111011        111111111         101111111111111111111111111111111
    101111111111111111111111111111101
    100000000000000000000000000000001
    111111111111111111111111111111111