NO ./textures/planks.xpm
EA ./textures/planks_3.xpm
WE ./textures/planks_3.xpm
SO ./textures/planks.xpm

F     0,000,0
C     49,82,135

 1111111        111111111
110000011      10000000001  111111
100000001     1000000000001 100001
 1000001     100000000000001101101
  11011      100000000000000101101
   101        10000001000000001101111
   101         100001 100000001100001
   1011111111111000001000000010000001
   1000000000000000000000000100000001
   1011111111111000000000001000000001
   101         1000000000010000000001
   101        10000000000111111111111
  11011      100000000001
 1000001     1000000N1001
100000001     10000000001
110000011      1000000001
 1111111        111111111