NO ./textures/brown.xpm
SO ./textures/texture_test.xpm
WE ./textures/texture_test.xpm
EA ./textures/texture_test.xpm

F     000,000,0
C     49,82,135


1111111
1000001
1N00001
1111111